1111111111111
1000000000001
1000011111001
1C0P110000011
1000000000001
1000011111001
1C00110000011
1000000000001
1100011111E0
1C0011C000011
1111111111111
