1111111111111
1111111111111
1111111111111
1111111111111
1111111111111
1111111111111
1111111111111
11XX11111CP11
1111111110E11
1111111111111
1111111111111
