1111111111111
1X0X0X0X00X01
10X0X111110X1
1C0011X0X0X11
100X0X0X0X001
10X0X111110X1
1C0X11X0X0X11
100X0X0X0XC11
1100111111E01
1C00C00000P11
1111111111111
