1111111111111
100XXX0000X01
1000011111001
1C0P110000011
1000000000001
1000011111001
1C00110000011
100X000000011
1100111111E01
1C00C00000011
1111111111111
